{
  "tileSize": 32,
  "tiles": [
    "..................................................",
    "..P...............................................",
    "..................................................",
    "..................................................",
    "..................................................",
    "..................................................",
    "..................................................",
    "..................................................",
    "..................................................",
    "..................................................",
    "..................................................",
    "..................................................",
    "..................................................",
    "............................######................",
    "..................................................",
    "..................................................",
    "..................................................",
    "..................................................",
    "####################....##########################",
    "####################....##########################"
  ],
  "enemies": [
    {
      "type": "goomba",
      "x": 15,
      "y": 17
    },
    {
      "type": "goomba",
      "x": 35,
      "y": 17
    }
  ],
  "items": [
    {
      "type": "coin",
      "x": 30,
      "y": 12
    },
    {
      "type": "coin",
      "x": 10,
      "y": 16
    },
    {
      "type": "mushroom",
      "x": 6,
      "y": 16
    },
    {
      "type": "fireflower",
      "x": 31,
      "y": 12
    }
  ]
}